############
#        O #
#   P   ####
#  X       #
#       X  #
#######    #
#  O ##  O #
#    ##    #
#          #
#   O  XX  #
#      #   #
############