############
# P    X  O#
######  ####
# O   X    #
#########  #
#O       X #
#  #########
# X       O#
############