########
#P     #
#OXO X #
#      #
########