#############
#     P     #
#           #
#     O     #
#           #
#     X     #
#           #
#############
