  #####
###   #
#OPX  #
### XO#
#O##X #
# # O ##
#X  X O#
#      #
########